[7,7]
(0,3)
(5,5)
(1,1,1,5)
(3,0,1,1)
(3,2,1,2)
(3,5,1,2)
(4,2,2,1)
