[10,10]
(3,8)
(8,6)
(0,4,4,2)
(5,1,1,5)
(5,7,1,3)
(7,2,1,6)
(8,7,2,1)
