[8,8]
(0,7)
(4,3)
(1,1,1,6)
(2,1,3,1)
(2,6,4,1)
(6,1,1,3)
(6,5,1,2)
